NO textures/wall_1.xpm
SO textures/wall_2.xpm
WE textures/wall_3.xpm
EA textures/wall_4.xpm

F 184,113,39
C 51,198,227

                   1111111111111111111111111111
                      1000000000111
10110000011100000000000010001
100100000000000000     010001
10110000011100000000000010001
10000000001100000111011110001
1110111111111011100000010001
11110111111111011101010010001
11000000110101011100000010001
100000000000   01100000010001
10000000000000001100010000001
11000000110101000000000000001
111111111101010000000000000001
10000000001100000100000010001
10000000000000000000000001001
10000000001000010000N00  100      1
10000000001101000000000000001
10000000000100000001010000001
11111111111111111111111111111
